#########################
#-----------#-----------#
#^###-#####-#-#####-###^#
#-----------------------#
#-###-#-#########-#-###-#
#-----#-----#-----#-----#
#####-#####-#-#####-#####
#####-#-----------#-#####
#####-#-###+++###-#-#####
--------##*****##--------
#####-#-#########-#-#####
#####-#-----------#-#####
#####-#####-#-#####-#####
#-----#-----#-----#-----#
#-###-#-#########-#-###-#
#-----------------------#
#^###-#####-#-#####-###^#
#-----------#-----------#
#########################
